111111111
1E00000C1
1M00000P1
111111111