11111111111111111111
1E0000010C0100000001
10000101000101010101
10000101000100010101
1P01000000000M0000C1
11111111111111111111