11111111111111111111
1E0000010C0100000001
10100101000101010101
101001011111000101M1
1P000000000000000MC1
11111111111111111111